10 10 20 5 100
20 11 15 20 1 6 2 1 10 16 15 15 6 13 11 8 12 8 11 19 1 8 12 14 4 2 13 18 14 12 2 14 16 6 19 10 6 6 1 1 5 17 9 13 3 4 7 11 5 20 12 10 1 18 11 19 9 9 4 5 16 9 18 2 16 20 8 7 8 7 6 1 14 4 17 12 15 1 14 14 2 12 6 11 2 8 12 8 20 10 14 9 5 1 15 20 4 7 5 19
15 9 16 20 17 13 7 11 11 6 9 4 11 19 16 3 17 16 10 20 2 9 11 6 5 12 7 7 20 17 14 4 2 16 1 11 7 11 8 6 9 13 12 18 4 2 7 16 16 8 10 15 1 13 3 18 20 2 10 15 20 15 20 8 11 12 6 20 18 3 4 6 10 3 18 2 9 17 3 16 17 9 3 9 15 15 12 7 10 10 9 20 8 13 3 14 9 8 17 17
8 2 14 18 15 12 4 15 6 16 3 7 14 15 18 11 2 11 17 20 7 2 4 11 4 7 7 3 4 10 2 2 19 17 19 18 11 4 5 9 16 3 19 3 17 13 2 20 16 1 12 17 15 16 10 19 13 8 11 1 1 4 12 1 9 3 6 19 17 14 14 13 17 1 1 14 1 13 1 8 15 9 18 3 2 5 8 20 5 14 3 10 14 10 12 20 8 15 8 12
15 4 7 18 6 15 18 15 13 17 20 8 17 6 10 17 4 20 17 7 6 7 12 10 20 10 6 11 18 12 16 17 12 4 11 12 8 1 9 7 19 6 5 18 13 9 20 12 2 7 6 3 14 12 10 16 7 3 13 12 6 3 19 7 16 3 2 12 9 3 8 1 18 8 8 1 14 11 6 6 14 16 14 8 19 5 8 16 8 16 13 17 12 16 13 12 11 13 10 1
7 17 15 17 2 11 12 14 6 13 9 13 14 4 18 11 3 1 2 18 17 18 19 17 8 3 1 11 8 5 12 3 13 10 3 7 3 2 2 19 20 6 8 9 4 11 18 15 8 6 2 11 16 1 7 17 6 12 15 13 14 20 19 3 14 16 8 16 13 3 14 3 8 9 13 4 2 13 13 16 1 18 18 14 11 5 16 20 14 14 1 20 2 11 17 4 8 1 1 19
8 20 19 3 14 9 16 8 2 14 11 15 14 2 2 11 16 17 11 6 16 6 17 15 1 16 2 6 18 14 6 13 16 6 5 9 2 3 6 9 14 17 18 19 10 14 7 10 10 11 11 19 12 12 15 10 11 12 3 17 8 11 5 13 13 17 5 16 9 15 7 1 9 20 11 16 11 13 5 8 20 17 9 16 10 4 4 10 12 18 20 2 18 7 7 19 4 16 19 9
9 1 14 6 7 17 17 2 8 5 15 1 12 20 1 20 2 10 11 2 17 20 20 16 16 3 3 7 3 13 18 10 19 20 12 7 11 20 6 18 14 20 17 11 13 4 6 3 1 5 17 15 8 8 15 20 2 16 11 14 20 18 15 18 12 6 8 9 7 11 14 7 19 3 8 8 19 20 20 2 1 7 18 11 15 19 7 13 20 4 7 7 5 12 6 1 18 17 7 3
10 1 14 14 12 14 8 19 14 14 12 4 7 2 17 16 20 13 5 11 2 15 20 18 16 19 2 4 14 2 9 17 20 1 2 13 17 13 1 13 18 8 14 1 20 19 3 18 5 18 4 10 5 19 18 16 11 15 7 10 13 17 13 19 14 4 17 14 18 15 1 12 15 19 13 18 15 13 7 15 16 5 10 15 3 15 20 4 8 19 10 11 6 10 7 14 14 10 11 5
20 14 15 7 10 19 10 14 15 18 2 5 11 4 19 1 10 2 15 14 10 8 15 12 16 8 8 13 1 3 6 16 9 8 5 19 1 4 1 17 10 16 11 19 17 13 20 12 20 9 14 10 16 6 9 16 13 12 4 9 11 14 20 13 15 6 16 2 13 1 5 20 15 13 3 2 14 13 13 1 11 8 10 9 4 9 1 19 8 2 10 4 9 9 9 4 4 20 7 7
19 4 2 18 6 19 2 13 6 15 17 11 17 6 3 19 17 17 18 1 13 14 11 12 13 10 14 19 2 17 18 10 9 19 1 3 10 10 15 8 1 9 1 6 4 9 16 10 15 14 17 7 16 20 19 1 1 10 10 8 20 3 3 8 17 11 6 11 13 4 11 11 7 9 16 7 19 3 13 8 2 15 5 8 13 7 1 17 3 13 3 3 13 16 8 16 5 7 8 3
0 0 0 0 0 0 0 0 0 0 0 0 0 0 0 0 0 0 0 0
0 0 0 0 0 0 0 0 0 0 0 0 0 0 0 0 0 0 0 0
1 20 2 20 3 20 4 20 5 20 6 20 7 20 8 20 9 20 10 20
11 20 12 20 13 20 14 20 15 20 16 20 17 20 18 20 19 20 20 20
21 20 22 20 23 20 24 20 25 20 26 20 27 20 28 20 29 20 30 20
1 1 2 1 3 1 0 0 0 0 0 0 0 0 0 0 0 0 0 0
0 0 0 0 2 10 2 10 0 0 0 0 0 0 0 0 0 0 0 0
0 0 2 10 2 15 2 10 0 0 0 0 0 0 0 0 0 0 0 0
0 0 0 0 2 10 2 10 0 0 0 0 0 0 0 0 0 0 0 0
0 0 0 0 0 0 0 0 0 0 0 0 0 0 0 0 0 0 0 0
