25 25
9 3 14 4 1 12 6 14 2 0 9 1 1 11 9 11 3 6 11 12 7 12 14 9 4
14 13 12 6 7 7 14 3 2 13 8 3 11 11 6 15 3 10 13 9 8 5 15 13 4
11 12 6 5 5 11 3 13 9 10 12 11 14 2 0 10 0 14 0 8 6 13 2 9 2
6 14 13 9 12 13 15 4 2 4 0 6 0 11 4 0 7 2 11 1 2 6 2 1 13
1 11 15 10 0 10 9 2 9 2 13 9 12 0 14 5 9 5 9 0 2 10 9 12 3
15 7 6 15 4 6 14 13 12 14 6 3 15 7 9 1 15 9 15 1 13 1 14 13 12
6 2 2 6 13 0 4 15 10 7 2 7 8 9 12 3 11 9 2 14 3 4 14 12 4
5 4 15 4 4 9 14 5 15 2 2 4 12 15 3 0 13 8 3 15 5 6 9 13 10
5 0 7 11 8 1 7 4 14 15 0 0 4 1 13 14 11 5 5 7 11 3 2 15 8
0 2 10 4 4 14 1 5 14 9 5 8 6 10 4 6 3 14 9 6 15 7 8 4 7
10 10 0 7 8 6 10 6 11 1 13 14 4 8 9 14 2 11 5 3 5 12 4 5 3
8 8 14 11 5 5 0 9 13 7 7 10 9 6 13 0 2 9 13 8 4 9 10 9 5
8 1 0 4 1 11 10 5 1 8 1 12 6 9 11 7 7 12 15 1 5 13 10 5 1
11 1 0 14 9 8 10 7 6 2 5 4 15 10 7 9 3 1 5 0 8 8 1 9 12
1 6 14 14 1 0 12 14 9 1 15 2 5 2 12 11 4 7 5 8 10 6 9 9 2
9 10 6 8 2 3 1 6 15 10 9 13 14 2 0 6 2 4 15 9 6 15 9 14 1
13 14 3 12 8 1 14 0 13 11 2 3 15 1 7 4 15 4 5 5 11 8 1 9 5
7 12 14 6 6 8 12 3 8 13 14 14 2 11 1 15 0 0 11 5 6 12 14 7 8
3 13 0 14 2 14 11 2 6 1 11 12 10 0 15 0 0 7 4 6 2 5 10 11 8
3 11 6 12 5 10 14 13 15 9 10 1 11 13 8 15 8 6 2 11 4 9 13 3 13
0 4 10 4 6 6 3 3 11 11 1 0 14 12 12 3 12 3 6 5 4 1 14 10 13
15 5 0 10 7 15 8 13 4 13 4 9 7 9 2 12 12 1 8 13 12 7 0 3 4
8 6 7 5 12 0 10 13 14 13 9 7 13 1 0 14 1 0 13 8 1 9 7 1 5
5 15 4 8 15 5 2 0 6 14 12 1 1 4 3 15 3 15 3 3 0 3 10 15 14
10 15 5 15 3 1 5 14 10 14 5 7 10 6 7 13 1 14 5 6 4 9 0 9 2
