20 20 20 10 400
17 2 17 17 4 14 8 8 15 17 18 2 12 19 5 9 6 16 12 11 19 4 7 9 5 18 14 2 18 10 17 8 20 17 4 8 9 10 10 2 6 20 19 4 10 9 11 11 2 1 11 1 2 12 18 9 2 4 12 4 10 14 17 14 3 6 17 12 15 12 11 3 15 18 20 8 7 16 18 1 1 19 1 9 14 5 20 20 1 12 2 5 13 9 6 3 6 7 13 5 15 19 20 13 2 6 14 16 14 14 11 20 17 17 8 1 10 4 17 4 14 2 1 5 7 4 5 12 16 20 19 7 2 20 8 10 10 9 4 7 9 15 17 2 4 20 3 3 20 1 6 15 4 11 8 9 16 2 4 18 2 2 8 10 11 11 3 9 17 6 6 16 2 16 16 9 7 15 7 6 18 11 17 20 13 7 7 19 12 16 1 19 16 17 2 11 9 19 18 9 13 10 1 9 14 1 13 3 2 11 10 14 5 19 9 2 19 13 15 20 10 13 20 13 18 12 15 8 11 20 20 4 3 1 20 13 9 17 15 6 13 16 19 11 16 16 19 15 3 6 7 13 19 14 15 15 19 12 11 3 14 19 9 9 3 18 7 12 10 9 10 12 19 9 7 13 5 15 13 6 20 10 15 20 15 10 16 4 9 4 16 18 10 20 1 4 4 18 18 18 7 8 19 11 10 2 17 12 6 7 14 7 4 16 16 19 14 11 10 18 18 9 16 11 3 14 5 9 4 20 18 11 18 19 20 18 20 20 17 8 20 9 11 10 13 16 5 16 8 6 6 12 11 2 11 4 12 14 16 4 9 9 18 7 4 13 8 1 18 15 7 1 7 5 15 3 20 3 10 9 20 5 15 14 8 12 19 7 11 3 7 5 12 20 3 7 17 19 4 16
15 10 20 15 7 18 18 11 5 5 8 9 19 8 13 12 1 15 18 7 10 6 4 4 1 2 3 17 12 9 2 11 9 2 11 15 8 17 16 20 16 1 18 16 9 7 16 10 1 6 3 8 6 7 9 10 12 3 20 14 11 2 9 2 18 14 12 19 13 17 14 11 9 20 4 6 14 20 13 16 13 9 15 10 19 1 6 17 20 10 18 11 16 3 14 13 15 11 12 12 11 7 7 17 3 9 3 18 2 14 19 6 9 18 17 17 12 16 10 6 14 19 3 2 12 11 15 4 16 17 14 15 7 14 3 16 11 5 1 14 16 19 7 16 13 2 5 5 3 10 1 10 10 7 9 5 3 3 11 11 1 3 18 10 6 19 11 17 5 11 12 10 6 19 20 14 9 16 16 10 10 4 7 19 8 2 16 10 1 10 7 6 18 18 1 11 15 18 10 13 17 16 20 16 6 20 14 5 1 10 12 12 2 17 17 19 12 11 18 3 13 1 13 2 18 13 10 9 4 18 4 15 3 8 12 1 5 7 17 15 12 20 19 19 11 18 5 13 14 15 9 3 13 16 12 1 7 16 5 11 15 3 10 14 2 2 16 9 10 7 14 9 7 19 1 15 5 14 14 20 17 18 16 13 15 18 12 17 7 9 19 15 2 19 15 20 11 11 20 4 7 1 16 16 14 3 1 13 15 3 13 10 6 19 4 19 16 19 10 20 19 14 11 20 6 19 11 8 14 2 13 3 18 16 11 7 13 7 19 15 3 17 4 18 17 18 12 8 20 8 17 4 2 11 5 18 3 6 14 14 3 8 18 8 9 2 12 1 3 7 19 10 7 17 18 4 10 16 8 16 14 17 9 4 6 13 17 17 4 14 13 14 14 16 3 5 18 11 2 16
2 1 14 7 20 19 4 4 5 13 5 15 4 1 11 3 5 16 20 5 2 7 3 4 11 15 17 8 13 4 13 11 20 11 11 13 5 2 9 6 1 20 17 13 8 1 13 3 16 11 13 6 18 10 13 20 1 1 11 15 16 9 17 13 10 17 6 19 20 3 5 18 7 10 6 6 11 9 10 3 15 2 13 16 18 11 14 6 17 1 1 13 5 9 15 12 4 16 3 19 11 17 8 16 19 2 20 7 1 16 7 11 10 11 7 4 2 9 10 10 7 8 12 1 14 5 14 19 2 4 15 16 20 1 7 8 13 9 14 10 17 14 18 3 20 7 15 8 12 8 5 8 15 17 7 13 5 20 15 10 11 16 2 5 17 19 9 11 13 7 4 4 13 16 10 11 19 1 13 13 18 18 12 1 20 12 18 4 7 7 5 9 8 16 10 16 18 10 19 11 18 15 10 10 3 6 4 11 17 11 6 20 2 20 10 19 8 15 9 14 15 10 20 13 1 17 5 16 5 10 3 9 14 17 5 2 20 7 6 11 11 5 5 3 10 1 15 15 5 16 1 11 15 4 12 4 18 3 10 17 12 9 19 14 19 11 12 2 8 8 6 19 13 20 10 20 10 3 8 2 8 15 17 3 13 13 6 19 11 2 10 19 5 8 11 20 18 2 11 12 11 20 20 16 6 12 6 17 20 18 4 18 17 5 18 2 14 18 13 10 16 9 15 7 14 6 9 1 2 13 3 18 20 20 19 4 16 4 12 4 3 19 11 1 19 10 3 4 10 11 17 14 12 8 19 3 8 13 15 12 17 17 11 19 9 12 3 16 17 13 8 4 10 6 2 6 12 1 12 6 5 19 19 13 20 4 6 8 10 1 8 20 5 17 11 18 12 15 20 9
10 10 6 5 18 6 8 16 14 11 17 18 18 15 14 13 8 17 15 18 6 3 9 15 7 3 11 1 2 14 7 5 7 16 15 14 3 12 9 13 14 19 3 9 7 7 6 16 20 10 18 14 10 10 5 16 3 15 16 3 2 16 7 6 8 7 3 17 5 7 2 20 12 18 1 16 18 2 20 20 15 3 11 14 11 20 16 15 13 3 9 4 18 1 4 11 12 18 20 1 3 12 1 5 20 3 11 5 4 12 7 12 3 10 3 16 13 14 11 16 13 16 19 12 16 11 6 11 13 9 4 2 15 19 1 8 13 15 6 10 1 10 3 11 14 13 5 10 4 6 4 3 18 20 13 19 6 20 10 8 9 1 18 12 11 15 11 5 5 6 5 9 16 16 17 3 13 16 9 6 8 8 14 4 13 11 19 17 10 16 4 9 5 2 14 16 8 12 9 8 14 19 4 8 15 5 20 15 8 20 3 7 16 12 10 15 14 17 9 11 1 12 6 18 20 15 17 12 9 15 2 5 13 2 20 2 12 18 8 3 15 16 16 16 13 4 14 8 17 9 4 7 18 8 10 3 8 17 2 17 12 4 6 17 1 4 15 19 12 18 5 3 5 18 4 11 7 19 13 12 18 3 7 10 19 11 15 12 19 3 6 20 12 14 18 18 12 5 8 3 3 6 4 15 19 19 5 7 18 19 3 13 5 12 18 13 14 9 6 9 2 6 11 15 12 10 13 13 16 1 12 6 5 14 8 3 2 1 13 16 14 17 17 20 13 16 10 2 16 4 9 2 13 10 3 3 1 15 4 3 15 18 17 20 1 17 2 11 7 20 3 6 10 12 6 6 11 18 10 11 1 5 14 8 12 14 18 17 3 14 9 2 3 3 2 5 12 15 4 20
17 16 16 9 19 16 10 13 15 15 10 6 13 11 1 1 19 2 14 8 5 7 18 16 20 18 16 9 19 13 5 16 19 7 10 17 9 11 18 3 5 18 7 9 15 4 1 18 9 4 17 19 9 9 6 3 20 7 1 16 15 3 18 8 12 4 12 11 12 19 1 15 4 4 20 7 12 20 14 16 16 17 10 20 5 17 10 1 10 4 3 14 11 12 13 1 17 17 7 9 4 4 3 20 17 20 1 19 13 8 8 9 6 20 14 6 6 14 17 1 17 18 18 4 14 1 9 17 14 11 17 8 1 7 5 4 1 3 3 15 16 12 12 15 4 19 8 5 16 5 19 15 10 4 9 12 11 10 6 18 19 13 1 1 6 8 6 14 2 9 13 6 13 19 17 20 13 2 16 1 7 9 1 7 13 15 16 3 11 2 1 7 20 11 7 14 16 10 10 2 12 9 11 16 18 14 15 6 3 2 7 2 14 11 10 20 18 6 7 2 2 17 12 15 20 19 12 17 19 5 1 20 9 7 1 9 5 8 6 12 16 7 7 12 11 2 6 4 20 3 3 3 4 8 2 16 8 19 19 16 19 19 4 16 7 9 16 1 16 6 19 13 1 16 11 11 12 11 5 15 8 10 2 12 17 15 20 9 20 15 8 5 15 1 14 2 12 12 7 20 13 19 6 11 14 13 4 19 10 14 20 3 15 16 11 20 8 5 8 18 20 20 20 14 13 14 12 2 18 11 3 15 4 16 13 5 3 12 4 20 1 14 10 9 14 17 19 2 10 15 13 7 8 13 1 9 11 8 20 12 2 20 6 16 19 9 18 19 11 10 2 2 20 16 16 9 16 4 12 16 19 12 8 12 11 16 18 17 18 19 13 4 19 11 18 4 5 5 4 5
12 18 18 6 5 15 4 3 16 2 17 1 11 13 4 9 6 6 20 14 10 8 20 19 19 13 15 8 9 5 12 3 20 6 5 6 6 16 20 12 9 2 19 13 2 13 5 10 14 13 9 8 14 3 3 15 4 10 11 10 20 12 20 5 4 18 18 16 16 14 16 18 12 5 17 8 7 5 15 11 8 5 12 19 16 7 13 6 7 17 20 8 18 15 18 4 12 15 9 2 15 2 2 7 5 15 11 14 4 13 15 8 11 6 18 11 6 17 10 18 8 3 10 8 18 5 10 18 3 1 15 2 14 4 16 1 16 7 5 11 19 8 16 14 2 2 10 16 9 16 11 13 15 19 11 4 18 11 6 20 7 11 3 7 19 19 2 2 9 9 20 7 9 3 18 3 16 8 16 10 13 9 19 9 15 6 9 7 8 13 1 3 14 10 13 4 16 7 18 17 15 2 11 19 2 13 14 12 18 18 8 10 10 19 10 20 6 11 7 17 5 14 8 1 13 9 18 7 14 1 10 13 4 2 15 9 5 15 7 10 16 5 15 2 7 7 20 1 10 11 18 13 17 6 17 4 4 1 16 3 13 17 13 8 2 4 6 10 15 12 17 16 10 8 20 7 5 13 14 12 12 18 13 9 4 18 10 6 7 17 14 4 17 10 12 1 10 1 10 15 5 13 13 13 20 19 15 18 9 16 20 5 16 11 4 12 18 10 2 9 13 18 13 10 17 13 10 20 7 9 3 6 9 2 18 3 17 20 13 17 17 4 8 16 5 19 11 6 10 13 18 16 4 4 11 17 11 18 11 9 3 18 15 9 7 10 8 1 14 17 1 6 9 19 4 17 9 17 15 7 1 20 20 7 10 2 3 5 1 20 15 20 8 15 16 15 9 6 12 10
11 18 7 16 11 14 15 16 6 14 19 4 7 11 19 17 16 9 10 18 12 11 3 9 15 6 14 3 6 17 13 4 20 12 12 18 1 16 9 9 17 5 8 3 4 9 20 12 17 12 14 20 8 9 10 20 20 4 19 3 13 4 11 18 13 2 3 18 4 11 11 20 18 3 1 5 8 2 14 11 3 8 13 4 4 11 17 14 7 16 1 10 7 10 18 4 13 18 12 3 4 19 16 5 13 3 10 18 2 11 17 10 4 8 3 16 18 11 11 17 20 11 15 12 12 4 11 2 1 9 15 5 13 9 1 13 9 7 19 19 8 20 9 13 9 1 18 6 4 17 8 14 14 4 14 9 15 9 5 1 14 9 1 8 11 9 8 10 15 16 17 18 20 12 15 1 18 15 20 12 7 1 4 14 18 16 1 1 2 10 5 11 13 14 9 20 17 14 19 2 15 12 3 17 15 16 2 8 19 13 9 16 7 18 20 15 20 10 12 12 19 19 9 13 1 12 4 5 13 9 6 7 9 15 1 2 20 12 15 19 20 7 11 12 16 8 3 19 4 19 7 14 3 11 7 3 13 13 9 11 13 17 19 11 5 4 16 7 17 10 8 2 12 7 12 2 5 16 9 16 6 7 7 7 2 11 7 14 4 20 8 2 2 15 20 20 19 16 14 7 4 9 19 14 1 10 16 13 7 18 2 12 13 9 7 7 12 6 11 16 7 19 9 6 15 10 9 20 2 19 10 2 2 15 20 5 1 7 1 20 6 17 11 2 14 14 7 3 1 9 13 3 18 7 9 20 6 11 16 10 11 16 17 3 3 5 1 17 9 4 9 17 14 10 12 14 9 1 16 5 8 15 13 17 1 11 3 14 13 2 19 2 6 7 13 8 15 14 4 5
8 5 15 11 15 4 15 3 18 15 17 6 10 5 17 12 4 7 7 18 1 18 5 16 7 13 17 4 2 15 5 20 16 7 4 6 1 8 18 3 9 19 19 19 7 11 3 7 2 1 6 18 6 11 7 4 2 10 2 3 11 15 6 4 7 14 7 14 7 5 4 5 2 6 16 18 7 4 3 17 20 15 3 4 16 7 8 14 10 17 11 1 19 3 1 8 18 1 4 11 6 20 14 1 8 20 14 13 9 20 19 20 6 13 2 18 15 4 16 2 16 7 16 7 2 2 1 8 5 16 3 14 14 1 2 15 16 16 8 3 15 5 9 3 16 16 20 10 2 6 7 4 16 19 5 19 8 1 3 19 8 17 1 1 7 7 3 16 10 10 3 4 3 8 20 6 6 15 16 19 14 2 10 12 6 6 15 18 17 4 14 7 2 9 9 1 16 11 10 10 18 8 10 19 14 4 9 9 7 4 10 5 19 11 16 18 2 16 9 8 20 6 6 16 5 15 19 18 11 12 5 18 3 11 1 2 8 3 6 16 4 16 10 20 17 10 5 11 7 12 11 2 3 7 11 12 15 1 20 13 14 15 19 1 15 2 17 8 5 1 14 7 6 1 13 19 4 19 6 9 7 6 10 14 20 13 18 20 9 15 11 12 14 3 8 9 20 11 20 13 8 3 18 10 10 11 10 4 19 1 6 14 8 12 1 2 12 10 6 12 19 18 12 9 7 1 9 20 15 10 5 5 7 13 16 14 7 6 6 19 11 13 17 8 7 11 4 16 14 2 16 4 20 10 20 14 9 1 13 16 8 16 17 12 4 10 11 5 4 4 12 14 20 10 16 17 15 14 8 14 12 14 14 5 2 10 2 17 15 2 12 7 6 1 2 7 12 19 15 4
12 20 12 6 6 13 6 3 6 10 8 19 12 9 10 9 7 11 18 17 18 16 15 11 19 20 11 20 14 15 17 12 20 8 18 3 1 5 11 8 14 2 8 15 3 20 12 10 12 4 1 6 19 13 9 18 5 9 4 8 12 15 4 3 16 9 11 2 20 19 12 7 20 8 1 5 17 19 6 18 9 14 10 8 11 2 14 3 5 18 10 16 8 18 12 15 4 14 2 1 9 7 4 12 12 12 17 7 6 5 6 7 18 20 1 10 9 10 10 6 3 17 16 18 15 9 2 19 4 15 11 1 14 16 7 3 2 3 11 8 10 15 12 11 18 15 6 10 16 3 18 3 15 10 2 15 9 20 17 6 3 14 19 11 20 15 1 3 14 17 8 8 8 12 6 4 3 15 2 16 15 5 13 10 4 2 5 20 14 10 5 14 6 16 5 17 7 11 3 10 15 13 14 7 5 1 6 1 3 11 4 6 19 17 8 7 8 12 20 12 14 19 11 18 5 20 5 13 18 13 16 12 10 8 8 2 1 9 15 14 19 8 13 13 16 15 6 2 1 6 15 14 20 5 9 6 8 4 4 10 15 4 5 19 4 6 6 11 8 13 6 7 2 13 11 1 10 18 7 11 16 9 7 12 2 17 14 14 11 4 13 12 20 13 17 20 14 1 9 3 2 17 2 12 18 15 17 14 5 6 3 10 4 11 7 13 10 2 11 18 5 13 20 6 14 11 20 19 15 20 8 6 2 12 19 5 17 13 16 1 4 9 7 8 19 4 7 13 4 14 2 18 11 7 5 18 13 3 2 5 14 1 20 17 13 15 5 18 13 16 2 8 8 8 10 19 19 19 3 16 10 9 18 18 6 9 13 19 8 9 4 16 18 9 15 18 8 5 13 3
8 4 18 13 9 14 16 4 10 17 12 18 3 12 8 2 19 12 19 5 17 12 1 13 16 3 11 11 20 15 6 4 6 8 12 10 7 1 14 8 10 14 1 7 6 3 6 10 17 15 20 4 10 1 9 13 12 3 8 10 4 4 17 5 1 20 13 13 14 9 3 5 4 9 19 3 12 9 14 19 15 11 19 4 12 15 5 3 6 11 20 9 7 1 16 15 19 2 3 12 13 15 7 13 15 10 17 14 13 14 12 19 12 8 8 14 19 15 16 2 17 1 9 3 8 14 5 12 2 19 9 5 6 15 15 3 17 19 19 8 9 16 18 3 17 5 15 8 7 16 14 16 3 1 14 16 8 2 16 6 16 2 20 11 15 8 2 3 12 5 5 14 7 9 10 4 6 10 1 15 7 15 8 8 10 8 20 11 7 17 19 15 6 4 6 6 13 15 12 16 5 10 16 10 17 13 4 5 11 9 17 16 8 8 4 2 11 6 2 14 17 1 4 9 15 8 10 2 3 3 18 4 20 14 15 1 13 13 10 5 8 15 19 1 14 10 5 5 13 2 4 16 9 11 7 19 13 4 1 3 11 9 18 6 1 9 6 12 8 20 2 2 4 19 16 4 5 14 20 15 6 16 14 13 1 18 2 20 14 8 18 9 7 9 3 14 3 6 2 14 10 8 15 3 16 18 7 19 5 3 11 15 13 2 13 1 19 19 3 10 15 14 1 8 20 14 18 20 3 17 10 18 6 10 10 11 8 11 16 20 2 10 9 13 9 1 4 17 12 17 17 4 20 11 18 16 10 12 5 12 6 15 18 10 18 8 6 8 20 16 12 18 19 2 19 14 19 4 20 19 4 14 17 6 1 6 18 1 5 4 15 10 5 8 3 1 16 10 19 9
0 0 0 0 0 0 0 0 0 0 0 0 0 0 0 0 0 0 0 0 0 0 0 0 0 0 0 0 0 0 0 0 0 0 0 0 0 0 0 0
0 0 0 0 0 0 0 0 0 0 0 0 0 0 0 0 0 0 0 0 0 0 0 0 0 0 0 0 0 0 0 0 0 0 0 0 0 0 0 0
0 0 0 0 0 0 0 0 0 0 0 0 0 0 0 0 0 0 0 0 0 0 0 0 0 0 0 0 0 0 0 0 0 0 0 0 0 0 0 0
0 0 0 0 0 0 0 0 0 0 0 0 0 0 0 0 0 0 0 0 0 0 0 0 0 0 0 0 0 0 0 0 0 0 0 0 0 0 0 0
0 0 0 0 0 0 0 0 0 0 0 0 0 0 0 0 0 0 0 0 0 0 0 0 0 0 0 0 0 0 0 0 0 0 0 0 0 0 0 0
0 0 0 0 0 0 0 0 0 0 0 0 0 0 0 0 0 0 0 0 0 0 0 0 0 0 0 0 0 0 0 0 0 0 0 0 0 0 0 0
0 0 0 0 0 0 0 0 0 0 0 0 0 0 0 0 0 0 0 0 0 0 0 0 0 0 0 0 0 0 0 0 0 0 0 0 0 0 0 0
0 0 0 0 0 0 0 0 0 0 0 0 0 0 0 0 0 0 0 0 0 0 0 0 0 0 0 0 0 0 0 0 0 0 0 0 0 0 0 0
0 0 0 0 0 0 0 0 0 0 0 0 0 0 0 0 0 0 0 0 0 0 0 0 0 0 0 0 0 0 0 0 0 0 0 0 0 0 0 0
0 0 0 0 0 0 0 0 0 0 0 0 0 0 0 0 0 0 0 0 0 0 0 0 0 0 0 0 0 0 0 0 0 0 0 0 0 0 0 0
0 0 0 0 0 0 0 0 0 0 0 0 0 0 0 0 0 0 0 0 0 0 0 0 0 0 0 0 0 0 0 0 0 0 0 0 0 0 0 0
0 0 0 0 0 0 0 0 0 0 0 0 0 0 0 0 0 0 0 0 0 0 0 0 0 0 0 0 0 0 0 0 0 0 0 0 0 0 0 0
0 0 0 0 0 0 0 0 0 0 0 0 0 0 0 0 0 0 0 0 0 0 0 0 0 0 0 0 0 0 0 0 0 0 0 0 0 0 0 0
0 0 0 0 0 0 0 0 0 0 0 0 0 0 0 0 0 0 0 0 0 0 0 0 0 0 0 0 0 0 0 0 0 0 0 0 0 0 0 0
0 0 0 0 0 0 0 0 0 0 0 0 0 0 0 0 0 0 0 0 0 0 0 0 0 0 0 0 0 0 0 0 0 0 0 0 0 0 0 0
0 0 0 0 0 0 0 0 0 0 0 0 0 0 0 0 0 0 0 0 0 0 0 0 0 0 0 0 0 0 0 0 0 0 0 0 0 0 0 0
0 0 0 0 0 0 0 0 0 0 0 0 0 0 0 0 0 0 0 0 0 0 0 0 0 0 0 0 0 0 0 0 0 0 0 0 0 0 0 0
0 0 0 0 0 0 0 0 0 0 0 0 0 0 0 0 0 0 0 0 0 0 0 0 0 0 0 0 0 0 0 0 0 0 0 0 0 0 0 0
0 0 0 0 0 0 0 0 0 0 0 0 0 0 0 0 0 0 0 0 0 0 0 0 0 0 0 0 0 0 0 0 0 0 0 0 0 0 0 0
0 0 0 0 0 0 0 0 0 0 0 0 0 0 0 0 0 0 0 0 0 0 0 0 0 0 0 0 0 0 0 0 0 0 0 0 0 0 0 0
